l u 
1 2 3 4 12 6 7 8 9 0 
1 2 3 4 5 6 7 8 9 0 
1 2 3 4 5 6 7 8 9 0 
1 2 3 4 5 6 7 8 9 0 
11 2 3 4 5 6 7 8 9 0 
1 2 3 4 5 6 7 8 9 0 
1 2 3 4 5 6 7 8 9 0 
1 2 3 4 5 6 7 8 9 0 
1 2 3 4 5 6 7 8 9 0 
1 2 3 4 5 6 7 8 9 0 