u u 
0 9 8 7 12 5 4 3 2 1 
1 2 3 4 5 6 7 8 9 0 
0 9 8 7 6 5 4 3 2 1 
1 2 3 4 5 6 7 8 9 0 
0 9 8 7 6 5 4 3 2 1 
1 2 3 4 5 6 7 8 9 0 
1 2 3 4 5 6 7 8 9 0 
1 2 3 4 5 6 7 8 9 0 
1 2 3 4 5 6 7 8 9 0 
1 2 3 4 11 6 7 8 9 0 